Unique,Average,Detached,Semi-Detached,Terraced,Flats,Other,Total,averagesValue,averages
Hartlepool,135812.4666,261,371,411,47,78,1168,232198.5479,averageDetached
Hartlepool,135812.4666,261,371,411,47,78,1168,124036.4501,averageSemi-Detached
Hartlepool,135812.4666,261,371,411,47,78,1168,63770.43309,averageTerraced
Hartlepool,135812.4666,261,371,411,47,78,1168,93711.70213,averageFlats
Hartlepool,135812.4666,261,371,411,47,78,1168,274275.8846,averageOther
Middlesbrough,143658.2619,359,625,590,69,60,1703,236621.6379,averageDetached
Middlesbrough,143658.2619,359,625,590,69,60,1703,132168.3728,averageSemi-Detached
Middlesbrough,143658.2619,359,625,590,69,60,1703,70079.18983,averageTerraced
Middlesbrough,143658.2619,359,625,590,69,60,1703,77092.75362,averageFlats
Middlesbrough,143658.2619,359,625,590,69,60,1703,507191.6167,averageOther
Redcar and Cleveland,139082.778,380,712,496,91,69,1748,220058.0263,averageDetached
Redcar and Cleveland,139082.778,380,712,496,91,69,1748,125599.9789,averageSemi-Detached
Redcar and Cleveland,139082.778,380,712,496,91,69,1748,86642.44556,averageTerraced
Redcar and Cleveland,139082.778,380,712,496,91,69,1748,105884.3736,averageFlats
Redcar and Cleveland,139082.778,380,712,496,91,69,1748,253004.7826,averageOther
Stockton-on-Tees,177457.2493,787,1042,665,83,115,2692,247012.4612,averageDetached
Stockton-on-Tees,177457.2493,787,1042,665,83,115,2692,129569.4443,averageSemi-Detached
Stockton-on-Tees,177457.2493,787,1042,665,83,115,2692,94857.57594,averageTerraced
Stockton-on-Tees,177457.2493,787,1042,665,83,115,2692,102772.9759,averageFlats
Stockton-on-Tees,177457.2493,787,1042,665,83,115,2692,666906.9739,averageOther
Darlington,161999.1167,294,530,455,88,72,1439,231001.7007,averageDetached
Darlington,161999.1167,294,530,455,88,72,1439,145969.2302,averageSemi-Detached
Darlington,161999.1167,294,530,455,88,72,1439,107001.9692,averageTerraced
Darlington,161999.1167,294,530,455,88,72,1439,108419.3182,averageFlats
Darlington,161999.1167,294,530,455,88,72,1439,411274.1806,averageOther
Halton,176444.3516,370,475,517,68,86,1516,255789.327,averageDetached
Halton,176444.3516,370,475,517,68,86,1516,144144.2716,averageSemi-Detached
Halton,176444.3516,370,475,517,68,86,1516,96958.07544,averageTerraced
Halton,176444.3516,370,475,517,68,86,1516,80714.61765,averageFlats
Halton,176444.3516,370,475,517,68,86,1516,567013.2326,averageOther
Warrington,245841.0646,674,1058,761,213,142,2848,332008.2626,averageDetached
Warrington,245841.0646,674,1058,761,213,142,2848,185337.5794,averageSemi-Detached
Warrington,245841.0646,674,1058,761,213,142,2848,134625.9001,averageTerraced
Warrington,245841.0646,674,1058,761,213,142,2848,112329.9577,averageFlats
Warrington,245841.0646,674,1058,761,213,142,2848,1083929.81,averageOther
Blackburn with Darwen,176948.038,241,395,802,44,96,1578,233506.2822,averageDetached
Blackburn with Darwen,176948.038,241,395,802,44,96,1578,135392.9747,averageSemi-Detached
Blackburn with Darwen,176948.038,241,395,802,44,96,1578,98859.72569,averageTerraced
Blackburn with Darwen,176948.038,241,395,802,44,96,1578,89975,averageFlats
Blackburn with Darwen,176948.038,241,395,802,44,96,1578,898170.4688,averageOther
Blackpool,130557.6397,155,835,776,176,159,2101,206403.2323,averageDetached
Blackpool,130557.6397,155,835,776,176,159,2101,123825.4144,averageSemi-Detached
Blackpool,130557.6397,155,835,776,176,159,2101,97223.72036,averageTerraced
Blackpool,130557.6397,155,835,776,176,159,2101,75438.64205,averageFlats
Blackpool,130557.6397,155,835,776,176,159,2101,315673.4025,averageOther
"Kingston upon Hull, City of",260771.6512,258,818,1106,136,225,2543,202810.5775,averageDetached
"Kingston upon Hull, City of",260771.6512,258,818,1106,136,225,2543,128529.3753,averageSemi-Detached
"Kingston upon Hull, City of",260771.6512,258,818,1106,136,225,2543,106473.6184,averageTerraced
"Kingston upon Hull, City of",260771.6512,258,818,1106,136,225,2543,107821.6029,averageFlats
"Kingston upon Hull, City of",260771.6512,258,818,1106,136,225,2543,1658918.182,averageOther
East Riding of Yorkshire,207393.8313,1896,1878,1322,428,243,5767,274616.0775,averageDetached
East Riding of Yorkshire,207393.8313,1896,1878,1322,428,243,5767,162027.9803,averageSemi-Detached
East Riding of Yorkshire,207393.8313,1896,1878,1322,428,243,5767,130728.2148,averageTerraced
East Riding of Yorkshire,207393.8313,1896,1878,1322,428,243,5767,114106.6192,averageFlats
East Riding of Yorkshire,207393.8313,1896,1878,1322,428,243,5767,614894.0823,averageOther
North East Lincolnshire,136434.7387,537,796,812,126,106,2377,206036.879,averageDetached
North East Lincolnshire,136434.7387,537,796,812,126,106,2377,133280.3291,averageSemi-Detached
North East Lincolnshire,136434.7387,537,796,812,126,106,2377,80330.70567,averageTerraced
North East Lincolnshire,136434.7387,537,796,812,126,106,2377,111782.9206,averageFlats
North East Lincolnshire,136434.7387,537,796,812,126,106,2377,266596.6698,averageOther
North Lincolnshire,162585.4947,910,907,380,59,101,2357,201649.5495,averageDetached
North Lincolnshire,162585.4947,910,907,380,59,101,2357,114022.4675,averageSemi-Detached
North Lincolnshire,162585.4947,910,907,380,59,101,2357,96663.91316,averageTerraced
North Lincolnshire,162585.4947,910,907,380,59,101,2357,67903.45763,averageFlats
North Lincolnshire,162585.4947,910,907,380,59,101,2357,550058.9307,averageOther
York,314505.1405,509,873,811,588,158,2939,372699.5521,averageDetached
York,314505.1405,509,873,811,588,158,2939,242076.1226,averageSemi-Detached
York,314505.1405,509,873,811,588,158,2939,250596.0049,averageTerraced
York,314505.1405,509,873,811,588,158,2939,235272.8605,averageFlats
York,314505.1405,509,873,811,588,158,2939,1150128.348,averageOther
Derby,198081.2046,807,1187,860,289,126,3269,251985.3742,averageDetached
Derby,198081.2046,807,1187,860,289,126,3269,149367.1247,averageSemi-Detached
Derby,198081.2046,807,1187,860,289,126,3269,118832.6209,averageTerraced
Derby,198081.2046,807,1187,860,289,126,3269,113866.7578,averageFlats
Derby,198081.2046,807,1187,860,289,126,3269,1045816.96,averageOther
Leicester,207405.8857,356,998,1311,538,602,3805,292534.0562,averageDetached
Leicester,207405.8857,356,998,1311,538,602,3805,175766.3567,averageSemi-Detached
Leicester,207405.8857,356,998,1311,538,602,3805,149098.1312,averageTerraced
Leicester,207405.8857,356,998,1311,538,602,3805,117448.4052,averageFlats
Leicester,207405.8857,356,998,1311,538,602,3805,416889.6262,averageOther
Rutland,313529.2544,264,141,159,29,36,629,392117.8561,averageDetached
Rutland,313529.2544,264,141,159,29,36,629,240875,averageSemi-Detached
Rutland,313529.2544,264,141,159,29,36,629,230891.8868,averageTerraced
Rutland,313529.2544,264,141,159,29,36,629,147538.1034,averageFlats
Rutland,313529.2544,264,141,159,29,36,629,520472.1389,averageOther
Nottingham,221201.0582,556,1033,1276,575,217,3657,250343.7212,averageDetached
Nottingham,221201.0582,556,1033,1276,575,217,3657,148178.7222,averageSemi-Detached
Nottingham,221201.0582,556,1033,1276,575,217,3657,114283.6826,averageTerraced
Nottingham,221201.0582,556,1033,1276,575,217,3657,126291.5478,averageFlats
Nottingham,221201.0582,556,1033,1276,575,217,3657,1374326.829,averageOther
"Herefordshire, County of",400813.6367,1328,964,858,522,311,3983,435857.8178,averageDetached
"Herefordshire, County of",400813.6367,1328,964,858,522,311,3983,326319.1245,averageSemi-Detached
"Herefordshire, County of",400813.6367,1328,964,858,522,311,3983,267534.5629,averageTerraced
"Herefordshire, County of",400813.6367,1328,964,858,522,311,3983,274178.1111,averageFlats
"Herefordshire, County of",400813.6367,1328,964,858,522,311,3983,1062328.836,averageOther
Telford and Wrekin,182661.943,887,792,645,145,128,2597,246697.4419,averageDetached
Telford and Wrekin,182661.943,887,792,645,145,128,2597,147160.202,averageSemi-Detached
Telford and Wrekin,182661.943,887,792,645,145,128,2597,125468.9876,averageTerraced
Telford and Wrekin,182661.943,887,792,645,145,128,2597,84135.64138,averageFlats
Telford and Wrekin,182661.943,887,792,645,145,128,2597,358393.6719,averageOther
Stoke-on-Trent,147358.9989,569,1376,1347,102,173,3567,205062.9525,averageDetached
Stoke-on-Trent,147358.9989,569,1376,1347,102,173,3567,115327.1483,averageSemi-Detached
Stoke-on-Trent,147358.9989,569,1376,1347,102,173,3567,78008.61915,averageTerraced
Stoke-on-Trent,147358.9989,569,1376,1347,102,173,3567,77872.83333,averageFlats
Stoke-on-Trent,147358.9989,569,1376,1347,102,173,3567,793282.8555,averageOther
Bath and North East Somerset,432289.0161,594,628,888,458,164,2732,524790.9327,averageDetached
Bath and North East Somerset,432289.0161,594,628,888,458,164,2732,334607.7468,averageSemi-Detached
Bath and North East Somerset,432289.0161,594,628,888,458,164,2732,351566.7218,averageTerraced
Bath and North East Somerset,432289.0161,594,628,888,458,164,2732,298699.3341,averageFlats
Bath and North East Somerset,432289.0161,594,628,888,458,164,2732,1281454.689,averageOther
"Bristol, City of",333367.5588,269,1273,2637,2146,341,6666,516278.9851,averageDetached
"Bristol, City of",333367.5588,269,1273,2637,2146,341,6666,319595.9914,averageSemi-Detached
"Bristol, City of",333367.5588,269,1273,2637,2146,341,6666,298550.5047,averageTerraced
"Bristol, City of",333367.5588,269,1273,2637,2146,341,6666,231888.0252,averageFlats
"Bristol, City of",333367.5588,269,1273,2637,2146,341,6666,1148369.56,averageOther
North Somerset,283339.1395,898,902,717,829,166,3512,392515.0947,averageDetached
North Somerset,283339.1395,898,902,717,829,166,3512,252387.5089,averageSemi-Detached
North Somerset,283339.1395,898,902,717,829,166,3512,222243.0962,averageTerraced
North Somerset,283339.1395,898,902,717,829,166,3512,171084.1098,averageFlats
North Somerset,283339.1395,898,902,717,829,166,3512,685409.2952,averageOther
South Gloucestershire,310098.6681,890,1161,1239,593,163,4046,395774.409,averageDetached
South Gloucestershire,310098.6681,890,1161,1239,593,163,4046,272250.9871,averageSemi-Detached
South Gloucestershire,310098.6681,890,1161,1239,593,163,4046,235124.912,averageTerraced
South Gloucestershire,310098.6681,890,1161,1239,593,163,4046,170400.1012,averageFlats
South Gloucestershire,310098.6681,890,1161,1239,593,163,4046,1189997.331,averageOther
Plymouth,228459.0288,412,922,1626,676,189,3825,299796.585,averageDetached
Plymouth,228459.0288,412,922,1626,676,189,3825,190640.5011,averageSemi-Detached
Plymouth,228459.0288,412,922,1626,676,189,3825,165757.5,averageTerraced
Plymouth,228459.0288,412,922,1626,676,189,3825,129874.0636,averageFlats
Plymouth,228459.0288,412,922,1626,676,189,3825,1149484.063,averageOther
Torbay,229424.9557,590,543,706,717,128,2684,317308.7271,averageDetached
Torbay,229424.9557,590,543,706,717,128,2684,211186.6814,averageSemi-Detached
Torbay,229424.9557,590,543,706,717,128,2684,180572.4504,averageTerraced
Torbay,229424.9557,590,543,706,717,128,2684,137942.9038,averageFlats
Torbay,229424.9557,590,543,706,717,128,2684,683600.4063,averageOther
Swindon,245750.7587,764,909,1368,695,123,3859,341826.6545,averageDetached
Swindon,245750.7587,764,909,1368,695,123,3859,236621.1199,averageSemi-Detached
Swindon,245750.7587,764,909,1368,695,123,3859,189504.7332,averageTerraced
Swindon,245750.7587,764,909,1368,695,123,3859,137734.9324,averageFlats
Swindon,245750.7587,764,909,1368,695,123,3859,952355.7967,averageOther
Peterborough,231853.9668,784,795,885,365,150,2979,287462.4911,averageDetached
Peterborough,231853.9668,784,795,885,365,150,2979,177108.1723,averageSemi-Detached
Peterborough,231853.9668,784,795,885,365,150,2979,142041.826,averageTerraced
Peterborough,231853.9668,784,795,885,365,150,2979,106471.6411,averageFlats
Peterborough,231853.9668,784,795,885,365,150,2979,1066348.08,averageOther
Luton,251296.8322,218,855,701,503,250,2527,372033.9725,averageDetached
Luton,251296.8322,218,855,701,503,250,2527,265300.552,averageSemi-Detached
Luton,251296.8322,218,855,701,503,250,2527,222680.5592,averageTerraced
Luton,251296.8322,218,855,701,503,250,2527,132782.0755,averageFlats
Luton,251296.8322,218,855,701,503,250,2527,416813.044,averageOther
Southend-on-Sea,286643.1074,366,685,600,1164,165,2980,493858.5246,averageDetached
Southend-on-Sea,286643.1074,366,685,600,1164,165,2980,335798.9401,averageSemi-Detached
Southend-on-Sea,286643.1074,366,685,600,1164,165,2980,276527.06,averageTerraced
Southend-on-Sea,286643.1074,366,685,600,1164,165,2980,189369.5902,averageFlats
Southend-on-Sea,286643.1074,366,685,600,1164,165,2980,345936.5273,averageOther
Thurrock,331189.3003,311,747,863,598,88,2607,432791.4855,averageDetached
Thurrock,331189.3003,311,747,863,598,88,2607,315912.5328,averageSemi-Detached
Thurrock,331189.3003,311,747,863,598,88,2607,265168.1356,averageTerraced
Thurrock,331189.3003,311,747,863,598,88,2607,173863.7793,averageFlats
Thurrock,331189.3003,311,747,863,598,88,2607,1818352.852,averageOther
Medway,250587.8815,480,1008,1923,590,144,4145,392761.6833,averageDetached
Medway,250587.8815,480,1008,1923,590,144,4145,271568.3988,averageSemi-Detached
Medway,250587.8815,480,1008,1923,590,144,4145,215796.8627,averageTerraced
Medway,250587.8815,480,1008,1923,590,144,4145,168061.9136,averageFlats
Medway,250587.8815,480,1008,1923,590,144,4145,432543.8819,averageOther
Bracknell Forest,500638.5792,387,359,549,356,79,1730,614645,averageDetached
Bracknell Forest,500638.5792,387,359,549,356,79,1730,397716.0446,averageSemi-Detached
Bracknell Forest,500638.5792,387,359,549,356,79,1730,330083.8506,averageTerraced
Bracknell Forest,500638.5792,387,359,549,356,79,1730,238196.4888,averageFlats
Bracknell Forest,500638.5792,387,359,549,356,79,1730,2777760.544,averageOther
West Berkshire,487576.8554,591,503,429,328,148,1999,597215.6396,averageDetached
West Berkshire,487576.8554,591,503,429,328,148,1999,349983.6223,averageSemi-Detached
West Berkshire,487576.8554,591,503,429,328,148,1999,298689.1282,averageTerraced
West Berkshire,487576.8554,591,503,429,328,148,1999,229855.3628,averageFlats
West Berkshire,487576.8554,591,503,429,328,148,1999,1636079.284,averageOther
Reading,401260.165,172,436,701,755,106,2170,572675.8837,averageDetached
Reading,401260.165,172,436,701,755,106,2170,380111.6537,averageSemi-Detached
Reading,401260.165,172,436,701,755,106,2170,311965.368,averageTerraced
Reading,401260.165,172,436,701,755,106,2170,237325.0358,averageFlats
Reading,401260.165,172,436,701,755,106,2170,1968278.302,averageOther
Slough,435270.6912,101,289,394,566,62,1412,536229.4554,averageDetached
Slough,435270.6912,101,289,394,566,62,1412,412199.5121,averageSemi-Detached
Slough,435270.6912,101,289,394,566,62,1412,334985.6624,averageTerraced
Slough,435270.6912,101,289,394,566,62,1412,224438.8445,averageFlats
Slough,435270.6912,101,289,394,566,62,1412,2940332.984,averageOther
Windsor and Maidenhead,710357.5317,458,402,385,436,147,1828,935525.3406,averageDetached
Windsor and Maidenhead,710357.5317,458,402,385,436,147,1828,502492.107,averageSemi-Detached
Windsor and Maidenhead,710357.5317,458,402,385,436,147,1828,496764.4597,averageTerraced
Windsor and Maidenhead,710357.5317,458,402,385,436,147,1828,384907.5826,averageFlats
Windsor and Maidenhead,710357.5317,458,402,385,436,147,1828,2101953.143,averageOther
Wokingham,477717.9863,795,573,447,373,80,2268,618244.7182,averageDetached
Wokingham,477717.9863,795,573,447,373,80,2268,415296.7365,averageSemi-Detached
Wokingham,477717.9863,795,573,447,373,80,2268,347449.311,averageTerraced
Wokingham,477717.9863,795,573,447,373,80,2268,259011.4424,averageFlats
Wokingham,477717.9863,795,573,447,373,80,2268,1275921.275,averageOther
Milton Keynes,327274.0382,985,938,1047,875,130,3975,426725.9807,averageDetached
Milton Keynes,327274.0382,985,938,1047,875,130,3975,270747.9392,averageSemi-Detached
Milton Keynes,327274.0382,985,938,1047,875,130,3975,227587.2684,averageTerraced
Milton Keynes,327274.0382,985,938,1047,875,130,3975,169198.0949,averageFlats
Milton Keynes,327274.0382,985,938,1047,875,130,3975,1848426.469,averageOther
Brighton and Hove,413506.4739,378,618,907,2017,269,4189,681196.7963,averageDetached
Brighton and Hove,413506.4739,378,618,907,2017,269,4189,439233.4045,averageSemi-Detached
Brighton and Hove,413506.4739,378,618,907,2017,269,4189,457369.1907,averageTerraced
Brighton and Hove,413506.4739,378,618,907,2017,269,4189,304015.1349,averageFlats
Brighton and Hove,413506.4739,378,618,907,2017,269,4189,651329.3792,averageOther
Portsmouth,252926.0914,116,308,1587,882,148,3041,433738.4828,averageDetached
Portsmouth,252926.0914,116,308,1587,882,148,3041,281337.039,averageSemi-Detached
Portsmouth,252926.0914,116,308,1587,882,148,3041,215992.8859,averageTerraced
Portsmouth,252926.0914,116,308,1587,882,148,3041,162474.5896,averageFlats
Portsmouth,252926.0914,116,308,1587,882,148,3041,987158.6081,averageOther
Southampton,348394.1229,415,726,754,1085,210,3190,325826.7253,averageDetached
Southampton,348394.1229,415,726,754,1085,210,3190,250198.719,averageSemi-Detached
Southampton,348394.1229,415,726,754,1085,210,3190,210804.8011,averageTerraced
Southampton,348394.1229,415,726,754,1085,210,3190,158491.6571,averageFlats
Southampton,348394.1229,415,726,754,1085,210,3190,2207641.062,averageOther
Isle of Wight,233882.6691,860,618,453,450,188,2569,325499.5988,averageDetached
Isle of Wight,233882.6691,860,618,453,450,188,2569,206333.6586,averageSemi-Detached
Isle of Wight,233882.6691,860,618,453,450,188,2569,171368.9536,averageTerraced
Isle of Wight,233882.6691,860,618,453,450,188,2569,142949.4333,averageFlats
Isle of Wight,233882.6691,860,618,453,450,188,2569,273634.7872,averageOther
County Durham,140147.028,1572,2073,3106,290,419,7460,223625.9459,averageDetached
County Durham,140147.028,1572,2073,3106,290,419,7460,117360.2161,averageSemi-Detached
County Durham,140147.028,1572,2073,3106,290,419,7460,78109.89247,averageTerraced
County Durham,140147.028,1572,2073,3106,290,419,7460,83133.13103,averageFlats
County Durham,140147.028,1572,2073,3106,290,419,7460,439024.2959,averageOther
Cheshire East,274913.0905,2139,1834,1612,622,303,6510,388939.9252,averageDetached
Cheshire East,274913.0905,2139,1834,1612,622,303,6510,208415.9471,averageSemi-Detached
Cheshire East,274913.0905,2139,1834,1612,622,303,6510,167102.4082,averageTerraced
Cheshire East,274913.0905,2139,1834,1612,622,303,6510,145861.926,averageFlats
Cheshire East,274913.0905,2139,1834,1612,622,303,6510,710929.6106,averageOther
Cheshire West and Chester,251683.0681,1597,1706,1165,443,229,5140,329833.8804,averageDetached
Cheshire West and Chester,251683.0681,1597,1706,1165,443,229,5140,189995.2145,averageSemi-Detached
Cheshire West and Chester,251683.0681,1597,1706,1165,443,229,5140,150208.8429,averageTerraced
Cheshire West and Chester,251683.0681,1597,1706,1165,443,229,5140,140828.0384,averageFlats
Cheshire West and Chester,251683.0681,1597,1706,1165,443,229,5140,896918.3581,averageOther
Shropshire,251904.5517,1859,1327,949,394,370,4899,310799.4185,averageDetached
Shropshire,251904.5517,1859,1327,949,394,370,4899,186582.682,averageSemi-Detached
Shropshire,251904.5517,1859,1327,949,394,370,4899,168935.5416,averageTerraced
Shropshire,251904.5517,1859,1327,949,394,370,4899,157664.3832,averageFlats
Shropshire,251904.5517,1859,1327,949,394,370,4899,503430.9865,averageOther
Cornwall,267415.7881,3379,1931,2730,1052,863,9955,341010.1749,averageDetached
Cornwall,267415.7881,3379,1931,2730,1052,863,9955,208005.3351,averageSemi-Detached
Cornwall,267415.7881,3379,1931,2730,1052,863,9955,190553.8725,averageTerraced
Cornwall,267415.7881,3379,1931,2730,1052,863,9955,180254.404,averageFlats
Cornwall,267415.7881,3379,1931,2730,1052,863,9955,461590.7103,averageOther
Isles of Scilly,374828.3448,1,5,3,12,8,29,417500,averageDetached
Isles of Scilly,374828.3448,1,5,3,12,8,29,380000,averageSemi-Detached
Isles of Scilly,374828.3448,1,5,3,12,8,29,326666.6667,averageTerraced
Isles of Scilly,374828.3448,1,5,3,12,8,29,252500,averageFlats
Isles of Scilly,374828.3448,1,5,3,12,8,29,567815.25,averageOther
Wiltshire,316404.1089,2445,1823,1977,936,430,7611,410134.6192,averageDetached
Wiltshire,316404.1089,2445,1823,1977,936,430,7611,265039.4849,averageSemi-Detached
Wiltshire,316404.1089,2445,1823,1977,936,430,7611,223231.6874,averageTerraced
Wiltshire,316404.1089,2445,1823,1977,936,430,7611,164424.4167,averageFlats
Wiltshire,316404.1089,2445,1823,1977,936,430,7611,760407.5535,averageOther
Bedford,333828.6299,691,758,701,420,135,2705,414955.5702,averageDetached
Bedford,333828.6299,691,758,701,420,135,2705,271223.81,averageSemi-Detached
Bedford,333828.6299,691,758,701,420,135,2705,228753.1598,averageTerraced
Bedford,333828.6299,691,758,701,420,135,2705,150736.5952,averageFlats
Bedford,333828.6299,691,758,701,420,135,2705,1385327.126,averageOther
Central Bedfordshire,357363.9586,1141,1275,1368,665,168,4617,458639.4084,averageDetached
Central Bedfordshire,357363.9586,1141,1275,1368,665,168,4617,301792.1184,averageSemi-Detached
Central Bedfordshire,357363.9586,1141,1275,1368,665,168,4617,253027.4189,averageTerraced
Central Bedfordshire,357363.9586,1141,1275,1368,665,168,4617,169279.3173,averageFlats
Central Bedfordshire,357363.9586,1141,1275,1368,665,168,4617,1685384.679,averageOther
Northumberland,209474.776,1438,1293,1382,454,339,4906,296887.1975,averageDetached
Northumberland,209474.776,1438,1293,1382,454,339,4906,154663.1214,averageSemi-Detached
Northumberland,209474.776,1438,1293,1382,454,339,4906,132024.6194,averageTerraced
Northumberland,209474.776,1438,1293,1382,454,339,4906,115421.7137,averageFlats
Northumberland,209474.776,1438,1293,1382,454,339,4906,489441.1888,averageOther
"Bournemouth, Christchurch and Poole",283838.5713,928,374,200,1753,200,3455,391412.4968,averageDetached
"Bournemouth, Christchurch and Poole",283838.5713,928,374,200,1753,200,3455,270897.3556,averageSemi-Detached
"Bournemouth, Christchurch and Poole",283838.5713,928,374,200,1753,200,3455,250978.335,averageTerraced
"Bournemouth, Christchurch and Poole",283838.5713,928,374,200,1753,200,3455,195976.2002,averageFlats
"Bournemouth, Christchurch and Poole",283838.5713,928,374,200,1753,200,3455,611869.55,averageOther
Dorset,330604.0046,2740,1253,1626,1297,415,7331,431805.1383,averageDetached
Dorset,330604.0046,2740,1253,1626,1297,415,7331,280402.4653,averageSemi-Detached
Dorset,330604.0046,2740,1253,1626,1297,415,7331,240370.3721,averageTerraced
Dorset,330604.0046,2740,1253,1626,1297,415,7331,194500.0308,averageFlats
Dorset,330604.0046,2740,1253,1626,1297,415,7331,592912.8313,averageOther
Buckinghamshire,495185.7319,2310,2016,1651,1541,495,8013,752424.055,averageDetached
Buckinghamshire,495185.7319,2310,2016,1651,1541,495,8013,401404.4772,averageSemi-Detached
Buckinghamshire,495185.7319,2310,2016,1651,1541,495,8013,344078.5197,averageTerraced
Buckinghamshire,495185.7319,2310,2016,1651,1541,495,8013,266528.5438,averageFlats
Buckinghamshire,495185.7319,2310,2016,1651,1541,495,8013,892521.5253,averageOther
North Northamptonshire,237926.4129,1643,1795,1802,431,682,6353,307918.3737,averageDetached
North Northamptonshire,237926.4129,1643,1795,1802,431,682,6353,188313.7643,averageSemi-Detached
North Northamptonshire,237926.4129,1643,1795,1802,431,682,6353,154896.5988,averageTerraced
North Northamptonshire,237926.4129,1643,1795,1802,431,682,6353,104570.3248,averageFlats
North Northamptonshire,237926.4129,1643,1795,1802,431,682,6353,503548.2771,averageOther
West Northamptonshire,346192.8641,1330,817,547,157,196,3047,400833.682,averageDetached
West Northamptonshire,346192.8641,1330,817,547,157,196,3047,250245.0306,averageSemi-Detached
West Northamptonshire,346192.8641,1330,817,547,157,196,3047,221529.17,averageTerraced
West Northamptonshire,346192.8641,1330,817,547,157,196,3047,146789.707,averageFlats
West Northamptonshire,346192.8641,1330,817,547,157,196,3047,883001.1735,averageOther
Bolton,180651.9957,624,1083,1436,318,251,3712,272861.6571,averageDetached
Bolton,180651.9957,624,1083,1436,318,251,3712,140673.7054,averageSemi-Detached
Bolton,180651.9957,624,1083,1436,318,251,3712,118728.9735,averageTerraced
Bolton,180651.9957,624,1083,1436,318,251,3712,91725.78931,averageFlats
Bolton,180651.9957,624,1083,1436,318,251,3712,590841.8486,averageOther
Bury,174010.6605,485,899,963,381,126,2854,288137.6103,averageDetached
Bury,174010.6605,485,899,963,381,126,2854,172218.6396,averageSemi-Detached
Bury,174010.6605,485,899,963,381,126,2854,124029.5327,averageTerraced
Bury,174010.6605,485,899,963,381,126,2854,137382.9081,averageFlats
Bury,174010.6605,485,899,963,381,126,2854,240252.373,averageOther
Manchester,272349.8611,282,1589,2140,2263,435,6709,328981.9113,averageDetached
Manchester,272349.8611,282,1589,2140,2263,435,6709,199199.5966,averageSemi-Detached
Manchester,272349.8611,282,1589,2140,2263,435,6709,145972.2804,averageTerraced
Manchester,272349.8611,282,1589,2140,2263,435,6709,170894.3305,averageFlats
Manchester,272349.8611,282,1589,2140,2263,435,6709,1652366.92,averageOther
Oldham,149654.6645,358,923,1189,92,171,2733,278516.1676,averageDetached
Oldham,149654.6645,358,923,1189,92,171,2733,149187.1896,averageSemi-Detached
Oldham,149654.6645,358,923,1189,92,171,2733,97525.69722,averageTerraced
Oldham,149654.6645,358,923,1189,92,171,2733,113736.5217,averageFlats
Oldham,149654.6645,358,923,1189,92,171,2733,264186.0819,averageOther
Rochdale,166686.7609,454,800,946,205,192,2597,246507.5595,averageDetached
Rochdale,166686.7609,454,800,946,205,192,2597,135309.5738,averageSemi-Detached
Rochdale,166686.7609,454,800,946,205,192,2597,105435.2907,averageTerraced
Rochdale,166686.7609,454,800,946,205,192,2597,69877.80488,averageFlats
Rochdale,166686.7609,454,800,946,205,192,2597,513836.9375,averageOther
Salford,200572.1505,356,1074,1213,1594,281,4518,289870.7303,averageDetached
Salford,200572.1505,356,1074,1213,1594,281,4518,172289.2654,averageSemi-Detached
Salford,200572.1505,356,1074,1213,1594,281,4518,130431.1913,averageTerraced
Salford,200572.1505,356,1074,1213,1594,281,4518,163920.3588,averageFlats
Salford,200572.1505,356,1074,1213,1594,281,4518,706228.605,averageOther
Stockport,264439.188,862,1698,1183,479,204,4426,380176.1671,averageDetached
Stockport,264439.188,862,1698,1183,479,204,4426,229443.9912,averageSemi-Detached
Stockport,264439.188,862,1698,1183,479,204,4426,158690.4497,averageTerraced
Stockport,264439.188,862,1698,1183,479,204,4426,128198.3716,averageFlats
Stockport,264439.188,862,1698,1183,479,204,4426,999815.0539,averageOther
Tameside,148480.5723,387,1031,1310,130,142,3000,262487.0284,averageDetached
Tameside,148480.5723,387,1031,1310,130,142,3000,152278.9554,averageSemi-Detached
Tameside,148480.5723,387,1031,1310,130,142,3000,111605.2809,averageTerraced
Tameside,148480.5723,387,1031,1310,130,142,3000,86789.34615,averageFlats
Tameside,148480.5723,387,1031,1310,130,142,3000,206859.8662,averageOther
Trafford,336358.05,454,1237,799,581,166,3237,603297.2533,averageDetached
Trafford,336358.05,454,1237,799,581,166,3237,297136.5707,averageSemi-Detached
Trafford,336358.05,454,1237,799,581,166,3237,235014.3755,averageTerraced
Trafford,336358.05,454,1237,799,581,166,3237,178927.1756,averageFlats
Trafford,336358.05,454,1237,799,581,166,3237,937367.1205,averageOther
Wigan,156111.1548,826,1656,1463,155,266,4366,230812.9044,averageDetached
Wigan,156111.1548,826,1656,1463,155,266,4366,133484.1021,averageSemi-Detached
Wigan,156111.1548,826,1656,1463,155,266,4366,97394.07314,averageTerraced
Wigan,156111.1548,826,1656,1463,155,266,4366,80724.16129,averageFlats
Wigan,156111.1548,826,1656,1463,155,266,4366,431881.188,averageOther
Knowsley,154428.6736,267,680,434,82,78,1541,213603.7528,averageDetached
Knowsley,154428.6736,267,680,434,82,78,1541,134267.2191,averageSemi-Detached
Knowsley,154428.6736,267,680,434,82,78,1541,88934.92857,averageTerraced
Knowsley,154428.6736,267,680,434,82,78,1541,77067.80488,averageFlats
Knowsley,154428.6736,267,680,434,82,78,1541,573376.359,averageOther
Liverpool,181772.2138,452,1452,2627,1581,669,6781,297464.6615,averageDetached
Liverpool,181772.2138,452,1452,2627,1581,669,6781,171583.5868,averageSemi-Detached
Liverpool,181772.2138,452,1452,2627,1581,669,6781,100000.2927,averageTerraced
Liverpool,181772.2138,452,1452,2627,1581,669,6781,112245.2891,averageFlats
Liverpool,181772.2138,452,1452,2627,1581,669,6781,611126.1824,averageOther
St. Helens,150879.2337,454,879,722,90,264,2409,240624.9714,averageDetached
St. Helens,150879.2337,454,879,722,90,264,2409,140199.1593,averageSemi-Detached
St. Helens,150879.2337,454,879,722,90,264,2409,92376.84626,averageTerraced
St. Helens,150879.2337,454,879,722,90,264,2409,78465.97778,averageFlats
St. Helens,150879.2337,454,879,722,90,264,2409,216785.0568,averageOther
Sefton,201762.391,611,1498,672,611,258,3650,336551.6219,averageDetached
Sefton,201762.391,611,1498,672,611,258,3650,171879.1509,averageSemi-Detached
Sefton,201762.391,611,1498,672,611,258,3650,106936.0551,averageTerraced
Sefton,201762.391,611,1498,672,611,258,3650,122037.7119,averageFlats
Sefton,201762.391,611,1498,672,611,258,3650,491855.2209,averageOther
Wirral,193474.9772,744,1793,1199,504,182,4422,329773.0269,averageDetached
Wirral,193474.9772,744,1793,1199,504,182,4422,173948.7027,averageSemi-Detached
Wirral,193474.9772,744,1793,1199,504,182,4422,111112.5955,averageTerraced
Wirral,193474.9772,744,1793,1199,504,182,4422,117009.6171,averageFlats
Wirral,193474.9772,744,1793,1199,504,182,4422,583012.8791,averageOther
Barnsley,139605.2436,813,1188,1023,176,154,3354,220001.6765,averageDetached
Barnsley,139605.2436,813,1188,1023,176,154,3354,112743.6911,averageSemi-Detached
Barnsley,139605.2436,813,1188,1023,176,154,3354,90900.54252,averageTerraced
Barnsley,139605.2436,813,1188,1023,176,154,3354,69215.65909,averageFlats
Barnsley,139605.2436,813,1188,1023,176,154,3354,326376.026,averageOther
Doncaster,164642.7994,1049,1637,971,103,183,3943,219094.6044,averageDetached
Doncaster,164642.7994,1049,1637,971,103,183,3943,120636.0464,averageSemi-Detached
Doncaster,164642.7994,1049,1637,971,103,183,3943,89444.92482,averageTerraced
Doncaster,164642.7994,1049,1637,971,103,183,3943,90426.26214,averageFlats
Doncaster,164642.7994,1049,1637,971,103,183,3943,686940.8907,averageOther
Rotherham,172651.7977,823,1399,711,157,163,3253,231239.6002,averageDetached
Rotherham,172651.7977,823,1399,711,157,163,3253,124939.96,averageSemi-Detached
Rotherham,172651.7977,823,1399,711,157,163,3253,91501.27004,averageTerraced
Rotherham,172651.7977,823,1399,711,157,163,3253,116614.3503,averageFlats
Rotherham,172651.7977,823,1399,711,157,163,3253,694289.8589,averageOther
Sheffield,247700.9649,987,2200,2150,1035,440,6812,314538.8845,averageDetached
Sheffield,247700.9649,987,2200,2150,1035,440,6812,172270.5823,averageSemi-Detached
Sheffield,247700.9649,987,2200,2150,1035,440,6812,138173.6958,averageTerraced
Sheffield,247700.9649,987,2200,2150,1035,440,6812,124086.8126,averageFlats
Sheffield,247700.9649,987,2200,2150,1035,440,6812,1300887.536,averageOther
Newcastle upon Tyne,229044.1404,370,947,1099,868,476,3760,304742.0946,averageDetached
Newcastle upon Tyne,229044.1404,370,947,1099,868,476,3760,183339.2883,averageSemi-Detached
Newcastle upon Tyne,229044.1404,370,947,1099,868,476,3760,177587.3749,averageTerraced
Newcastle upon Tyne,229044.1404,370,947,1099,868,476,3760,139852.9194,averageFlats
Newcastle upon Tyne,229044.1404,370,947,1099,868,476,3760,542580.3109,averageOther
North Tyneside,187409.0087,490,997,946,606,162,3201,278950.6286,averageDetached
North Tyneside,187409.0087,490,997,946,606,162,3201,179409.8576,averageSemi-Detached
North Tyneside,187409.0087,490,997,946,606,162,3201,161507.5338,averageTerraced
North Tyneside,187409.0087,490,997,946,606,162,3201,109560.6485,averageFlats
North Tyneside,187409.0087,490,997,946,606,162,3201,402215.5617,averageOther
South Tyneside,148052.3211,205,549,548,245,138,1685,274523.4878,averageDetached
South Tyneside,148052.3211,205,549,548,245,138,1685,147775.0401,averageSemi-Detached
South Tyneside,148052.3211,205,549,548,245,138,1685,113949.3266,averageTerraced
South Tyneside,148052.3211,205,549,548,245,138,1685,82346.93878,averageFlats
South Tyneside,148052.3211,205,549,548,245,138,1685,213355.9275,averageOther
Sunderland,146649.056,494,1084,1103,321,213,3215,226481.5668,averageDetached
Sunderland,146649.056,494,1084,1103,321,213,3215,129972.9068,averageSemi-Detached
Sunderland,146649.056,494,1084,1103,321,213,3215,95664.7806,averageTerraced
Sunderland,146649.056,494,1084,1103,321,213,3215,68277.63551,averageFlats
Sunderland,146649.056,494,1084,1103,321,213,3215,428492.0939,averageOther
Birmingham,251830.8611,1136,3567,4190,2180,755,11828,385310.272,averageDetached
Birmingham,251830.8611,1136,3567,4190,2180,755,11828,195330.0684,averageSemi-Detached
Birmingham,251830.8611,1136,3567,4190,2180,755,11828,153222.0289,averageTerraced
Birmingham,251830.8611,1136,3567,4190,2180,755,11828,145032.4018,averageFlats
Birmingham,251830.8611,1136,3567,4190,2180,755,11828,1173549.225,averageOther
Coventry,201051.045,431,1086,2083,586,148,4334,321038.761,averageDetached
Coventry,201051.045,431,1086,2083,586,148,4334,193698.9899,averageSemi-Detached
Coventry,201051.045,431,1086,2083,586,148,4334,152755.977,averageTerraced
Coventry,201051.045,431,1086,2083,586,148,4334,120253.8447,averageFlats
Coventry,201051.045,431,1086,2083,586,148,4334,905209.2365,averageOther
Dudley,185343.1554,824,1455,926,321,154,3680,259407.9163,averageDetached
Dudley,185343.1554,824,1455,926,321,154,3680,156844.8371,averageSemi-Detached
Dudley,185343.1554,824,1455,926,321,154,3680,139134.0551,averageTerraced
Dudley,185343.1554,824,1455,926,321,154,3680,97583.69159,averageFlats
Dudley,185343.1554,824,1455,926,321,154,3680,519084.0974,averageOther
Sandwell,165406.0577,364,1196,1085,291,185,3121,216784.3379,averageDetached
Sandwell,165406.0577,364,1196,1085,291,185,3121,142493.0727,averageSemi-Detached
Sandwell,165406.0577,364,1196,1085,291,185,3121,139346.2664,averageTerraced
Sandwell,165406.0577,364,1196,1085,291,185,3121,79055.31959,averageFlats
Sandwell,165406.0577,364,1196,1085,291,185,3121,501109.7027,averageOther
Solihull,349199.9348,759,997,597,594,103,3050,508343.7839,averageDetached
Solihull,349199.9348,759,997,597,594,103,3050,267871.4664,averageSemi-Detached
Solihull,349199.9348,759,997,597,594,103,3050,212925.4757,averageTerraced
Solihull,349199.9348,759,997,597,594,103,3050,171624.5741,averageFlats
Solihull,349199.9348,759,997,597,594,103,3050,1777645.738,averageOther
Walsall,191985.411,579,1137,853,292,149,3010,279276.4145,averageDetached
Walsall,191985.411,579,1137,853,292,149,3010,155507.5215,averageSemi-Detached
Walsall,191985.411,579,1137,853,292,149,3010,123418.0516,averageTerraced
Walsall,191985.411,579,1137,853,292,149,3010,96415.17466,averageFlats
Walsall,191985.411,579,1137,853,292,149,3010,710967.5302,averageOther
Wolverhampton,170841.8553,504,1115,672,279,125,2695,254938.3988,averageDetached
Wolverhampton,170841.8553,504,1115,672,279,125,2695,138086.8565,averageSemi-Detached
Wolverhampton,170841.8553,504,1115,672,279,125,2695,112983.0908,averageTerraced
Wolverhampton,170841.8553,504,1115,672,279,125,2695,95205.86738,averageFlats
Wolverhampton,170841.8553,504,1115,672,279,125,2695,603807.424,averageOther
Bradford,160899.08,1027,2160,2518,619,1079,7403,293006.9942,averageDetached
Bradford,160899.08,1027,2160,2518,619,1079,7403,147170.4829,averageSemi-Detached
Bradford,160899.08,1027,2160,2518,619,1079,7403,114862.72,averageTerraced
Bradford,160899.08,1027,2160,2518,619,1079,7403,106000.3393,averageFlats
Bradford,160899.08,1027,2160,2518,619,1079,7403,201567.1214,averageOther
Calderdale,182805.0928,434,747,1381,175,206,2943,316880.318,averageDetached
Calderdale,182805.0928,434,747,1381,175,206,2943,159168.0268,averageSemi-Detached
Calderdale,182805.0928,434,747,1381,175,206,2943,112482.6401,averageTerraced
Calderdale,182805.0928,434,747,1381,175,206,2943,113510.7429,averageFlats
Calderdale,182805.0928,434,747,1381,175,206,2943,516349.068,averageOther
Kirklees,170515.7648,1223,1589,2029,333,416,5590,271582.3074,averageDetached
Kirklees,170515.7648,1223,1589,2029,333,416,5590,148617.056,averageSemi-Detached
Kirklees,170515.7648,1223,1589,2029,333,416,5590,114256.5683,averageTerraced
Kirklees,170515.7648,1223,1589,2029,333,416,5590,92595.8018,averageFlats
Kirklees,170515.7648,1223,1589,2029,333,416,5590,293808.851,averageOther
Leeds,234081.1634,1746,3831,3452,1785,490,11304,363914.3511,averageDetached
Leeds,234081.1634,1746,3831,3452,1785,490,11304,191584.3229,averageSemi-Detached
Leeds,234081.1634,1746,3831,3452,1785,490,11304,145802.3722,averageTerraced
Leeds,234081.1634,1746,3831,3452,1785,490,11304,139930.7905,averageFlats
Leeds,234081.1634,1746,3831,3452,1785,490,11304,1068598.414,averageOther
Wakefield,170940.5659,1327,1967,1505,221,195,5215,242832.6895,averageDetached
Wakefield,170940.5659,1327,1967,1505,221,195,5215,136905.0605,averageSemi-Detached
Wakefield,170940.5659,1327,1967,1505,221,195,5215,106951.6179,averageTerraced
Wakefield,170940.5659,1327,1967,1505,221,195,5215,89133.55656,averageFlats
Wakefield,170940.5659,1327,1967,1505,221,195,5215,611605.7282,averageOther
Gateshead,177604.0974,256,818,793,468,171,2506,250694.9023,averageDetached
Gateshead,177604.0974,256,818,793,468,171,2506,147390.5416,averageSemi-Detached
Gateshead,177604.0974,256,818,793,468,171,2506,124903.0214,averageTerraced
Gateshead,177604.0974,256,818,793,468,171,2506,104999.0513,averageFlats
Gateshead,177604.0974,256,818,793,468,171,2506,655817.883,averageOther
City of London,6828867.576,0,0,2,104,97,203,0,averageDetached
City of London,6828867.576,0,0,2,104,97,203,0,averageSemi-Detached
City of London,6828867.576,0,0,2,104,97,203,2146500,averageTerraced
City of London,6828867.576,0,0,2,104,97,203,957475.0481,averageFlats
City of London,6828867.576,0,0,2,104,97,203,13220512.51,averageOther
Barking and Dagenham,312383.1275,13,204,1144,410,64,1835,409423.0769,averageDetached
Barking and Dagenham,312383.1275,13,204,1144,410,64,1835,364576.7892,averageSemi-Detached
Barking and Dagenham,312383.1275,13,204,1144,410,64,1835,320817.5997,averageTerraced
Barking and Dagenham,312383.1275,13,204,1144,410,64,1835,216456.8195,averageFlats
Barking and Dagenham,312383.1275,13,204,1144,410,64,1835,590066.3125,averageOther
Barnet,652271.9238,284,763,669,2083,244,4043,1490789.542,averageDetached
Barnet,652271.9238,284,763,669,2083,244,4043,775923.5007,averageSemi-Detached
Barnet,652271.9238,284,763,669,2083,244,4043,593713.9492,averageTerraced
Barnet,652271.9238,284,763,669,2083,244,4043,415064.1719,averageFlats
Barnet,652271.9238,284,763,669,2083,244,4043,1475197.643,averageOther
Bexley,376968.4594,155,958,999,746,109,2967,550884.4323,averageDetached
Bexley,376968.4594,155,958,999,746,109,2967,411126.4916,averageSemi-Detached
Bexley,376968.4594,155,958,999,746,109,2967,333658.8128,averageTerraced
Bexley,376968.4594,155,958,999,746,109,2967,222340.5402,averageFlats
Bexley,376968.4594,155,958,999,746,109,2967,1284660.147,averageOther
Brent,679926.4162,71,305,392,1530,201,2499,1104590.845,averageDetached
Brent,679926.4162,71,305,392,1530,201,2499,736312.0689,averageSemi-Detached
Brent,679926.4162,71,305,392,1530,201,2499,716675.2321,averageTerraced
Brent,679926.4162,71,305,392,1530,201,2499,420150.1203,averageFlats
Brent,679926.4162,71,305,392,1530,201,2499,2350092.577,averageOther
Bromley,570900.4882,618,984,972,1454,183,4211,846778.1165,averageDetached
Bromley,570900.4882,618,984,972,1454,183,4211,537806.6809,averageSemi-Detached
Bromley,570900.4882,618,984,972,1454,183,4211,442908.0936,averageTerraced
Bromley,570900.4882,618,984,972,1454,183,4211,330738.7105,averageFlats
Bromley,570900.4882,618,984,972,1454,183,4211,2405194.284,averageOther
Camden,1464200.279,40,51,182,1531,295,2099,5197638.85,averageDetached
Camden,1464200.279,40,51,182,1531,295,2099,3209268.627,averageSemi-Detached
Camden,1464200.279,40,51,182,1531,295,2099,1983573.44,averageTerraced
Camden,1464200.279,40,51,182,1531,295,2099,811026.3423,averageFlats
Camden,1464200.279,40,51,182,1531,295,2099,3725716.732,averageOther
Croydon,446637.1774,431,737,1114,2125,255,4662,690847.413,averageDetached
Croydon,446637.1774,431,737,1114,2125,255,4662,481413.9457,averageSemi-Detached
Croydon,446637.1774,431,737,1114,2125,255,4662,383143.2469,averageTerraced
Croydon,446637.1774,431,737,1114,2125,255,4662,285849.3911,averageFlats
Croydon,446637.1774,431,737,1114,2125,255,4662,1550641.863,averageOther
Ealing,928263.1128,77,411,728,1406,258,2880,1355157.143,averageDetached
Ealing,928263.1128,77,411,728,1406,258,2880,723247.8467,averageSemi-Detached
Ealing,928263.1128,77,411,728,1406,258,2880,618093.7679,averageTerraced
Ealing,928263.1128,77,411,728,1406,258,2880,439710.2354,averageFlats
Ealing,928263.1128,77,411,728,1406,258,2880,4665081.186,averageOther
Enfield,488454.8948,122,443,1017,1072,179,2833,1092279.516,averageDetached
Enfield,488454.8948,122,443,1017,1072,179,2833,606206.1783,averageSemi-Detached
Enfield,488454.8948,122,443,1017,1072,179,2833,443851.3658,averageTerraced
Enfield,488454.8948,122,443,1017,1072,179,2833,309414.3563,averageFlats
Enfield,488454.8948,122,443,1017,1072,179,2833,1111152.235,averageOther
Greenwich,505129.025,64,326,907,1763,138,3198,933706.9531,averageDetached
Greenwich,505129.025,64,326,907,1763,138,3198,529397.5767,averageSemi-Detached
Greenwich,505129.025,64,326,907,1763,138,3198,457831.2161,averageTerraced
Greenwich,505129.025,64,326,907,1763,138,3198,408708.0743,averageFlats
Greenwich,505129.025,64,326,907,1763,138,3198,1791713.906,averageOther
Hackney,772976.07,7,26,327,1690,192,2242,2060857.143,averageDetached
Hackney,772976.07,7,26,327,1690,192,2242,1157042.308,averageSemi-Detached
Hackney,772976.07,7,26,327,1690,192,2242,998673.5321,averageTerraced
Hackney,772976.07,7,26,327,1690,192,2242,516636.7621,averageFlats
Hackney,772976.07,7,26,327,1690,192,2242,2545942.063,averageOther
Hammersmith and Fulham,1021593.947,8,28,400,1241,192,1869,1596875,averageDetached
Hammersmith and Fulham,1021593.947,8,28,400,1241,192,1869,1716519.821,averageSemi-Detached
Hammersmith and Fulham,1021593.947,8,28,400,1241,192,1869,1441182.55,averageTerraced
Hammersmith and Fulham,1021593.947,8,28,400,1241,192,1869,766509.3247,averageFlats
Hammersmith and Fulham,1021593.947,8,28,400,1241,192,1869,1670887.708,averageOther
Haringey,644851.5993,33,112,623,1010,211,1989,1821974.97,averageDetached
Haringey,644851.5993,33,112,623,1010,211,1989,1076607.884,averageSemi-Detached
Haringey,644851.5993,33,112,623,1010,211,1989,751439.8941,averageTerraced
Haringey,644851.5993,33,112,623,1010,211,1989,444809.2782,averageFlats
Haringey,644851.5993,33,112,623,1010,211,1989,874408.2891,averageOther
Harrow,574239.6992,156,513,443,661,135,1908,1030646.635,averageDetached
Harrow,574239.6992,156,513,443,661,135,1908,581506.4932,averageSemi-Detached
Harrow,574239.6992,156,513,443,661,135,1908,499467.5553,averageTerraced
Harrow,574239.6992,156,513,443,661,135,1908,345296.7716,averageFlats
Harrow,574239.6992,156,513,443,661,135,1908,1385558.126,averageOther
Havering,392454.9731,292,1034,911,866,126,3229,647960.7363,averageDetached
Havering,392454.9731,292,1034,911,866,126,3229,414664.3433,averageSemi-Detached
Havering,392454.9731,292,1034,911,866,126,3229,355201.5554,averageTerraced
Havering,392454.9731,292,1034,911,866,126,3229,244286.4261,averageFlats
Havering,392454.9731,292,1034,911,866,126,3229,905785.5556,averageOther
Hillingdon,544681.7443,298,770,696,1066,158,2988,809707.2148,averageDetached
Hillingdon,544681.7443,298,770,696,1066,158,2988,489938.6143,averageSemi-Detached
Hillingdon,544681.7443,298,770,696,1066,158,2988,435632.4626,averageTerraced
Hillingdon,544681.7443,298,770,696,1066,158,2988,292276.4719,averageFlats
Hillingdon,544681.7443,298,770,696,1066,158,2988,2494915.544,averageOther
Hounslow,662988.633,62,439,550,1242,151,2444,940314.3548,averageDetached
Hounslow,662988.633,62,439,550,1242,151,2444,622899.5467,averageSemi-Detached
Hounslow,662988.633,62,439,550,1242,151,2444,564170.7764,averageTerraced
Hounslow,662988.633,62,439,550,1242,151,2444,349927.818,averageFlats
Hounslow,662988.633,62,439,550,1242,151,2444,3600579.808,averageOther
Islington,882766.3509,5,24,269,1240,206,1744,2537480,averageDetached
Islington,882766.3509,5,24,269,1240,206,1744,1829789.583,averageSemi-Detached
Islington,882766.3509,5,24,269,1240,206,1744,1337192.022,averageTerraced
Islington,882766.3509,5,24,269,1240,206,1744,601021.8774,averageFlats
Islington,882766.3509,5,24,269,1240,206,1744,1834807.689,averageOther
Kensington and Chelsea,2196349.744,7,19,272,1176,210,1684,15635714.29,averageDetached
Kensington and Chelsea,2196349.744,7,19,272,1176,210,1684,5436421.053,averageSemi-Detached
Kensington and Chelsea,2196349.744,7,19,272,1176,210,1684,4160846.077,averageTerraced
Kensington and Chelsea,2196349.744,7,19,272,1176,210,1684,1517538.87,averageFlats
Kensington and Chelsea,2196349.744,7,19,272,1176,210,1684,2712072.024,averageOther
Kingston upon Thames,662103.0672,175,470,335,648,112,1740,1074432.943,averageDetached
Kingston upon Thames,662103.0672,175,470,335,648,112,1740,643556.6787,averageSemi-Detached
Kingston upon Thames,662103.0672,175,470,335,648,112,1740,515022.9493,averageTerraced
Kingston upon Thames,662103.0672,175,470,335,648,112,1740,375041.9306,averageFlats
Kingston upon Thames,662103.0672,175,470,335,648,112,1740,2196447.089,averageOther
Lambeth,658333.9484,26,152,566,2222,270,3236,1343346.154,averageDetached
Lambeth,658333.9484,26,152,566,2222,270,3236,983178.6053,averageSemi-Detached
Lambeth,658333.9484,26,152,566,2222,270,3236,854397.6431,averageTerraced
Lambeth,658333.9484,26,152,566,2222,270,3236,484799.671,averageFlats
Lambeth,658333.9484,26,152,566,2222,270,3236,1426609.533,averageOther
Lewisham,490055.831,31,234,936,1719,217,3137,1084294.387,averageDetached
Lewisham,490055.831,31,234,936,1719,217,3137,625816.547,averageSemi-Detached
Lewisham,490055.831,31,234,936,1719,217,3137,534050.8857,averageTerraced
Lewisham,490055.831,31,234,936,1719,217,3137,354753.5375,averageFlats
Lewisham,490055.831,31,234,936,1719,217,3137,1140820.203,averageOther
Merton,651911.9372,92,232,896,842,137,2199,2302137.348,averageDetached
Merton,651911.9372,92,232,896,842,137,2199,820999.7457,averageSemi-Detached
Merton,651911.9372,92,232,896,842,137,2199,596661.1641,averageTerraced
Merton,651911.9372,92,232,896,842,137,2199,378835.0986,averageFlats
Merton,651911.9372,92,232,896,842,137,2199,1297067.277,averageOther
Newham,421161.1188,11,32,893,1921,148,3005,631909.0909,averageDetached
Newham,421161.1188,11,32,893,1921,148,3005,432800,averageSemi-Detached
Newham,421161.1188,11,32,893,1921,148,3005,424936.6282,averageTerraced
Newham,421161.1188,11,32,893,1921,148,3005,346559.9412,averageFlats
Newham,421161.1188,11,32,893,1921,148,3005,1348503.419,averageOther
Redbridge,471865.6199,95,415,1023,872,168,2573,774022.0947,averageDetached
Redbridge,471865.6199,95,415,1023,872,168,2573,560321.3325,averageSemi-Detached
Redbridge,471865.6199,95,415,1023,872,168,2573,462369.7986,averageTerraced
Redbridge,471865.6199,95,415,1023,872,168,2573,293816.8463,averageFlats
Redbridge,471865.6199,95,415,1023,872,168,2573,1064477.345,averageOther
Richmond upon Thames,844574.6991,135,436,740,951,201,2463,1513246.489,averageDetached
Richmond upon Thames,844574.6991,135,436,740,951,201,2463,1040584.016,averageSemi-Detached
Richmond upon Thames,844574.6991,135,436,740,951,201,2463,848948.4811,averageTerraced
Richmond upon Thames,844574.6991,135,436,740,951,201,2463,502092.4648,averageFlats
Richmond upon Thames,844574.6991,135,436,740,951,201,2463,1574590.881,averageOther
Southwark,834655.2036,26,86,455,2131,229,2927,1667653.846,averageDetached
Southwark,834655.2036,26,86,455,2131,229,2927,1163390.244,averageSemi-Detached
Southwark,834655.2036,26,86,455,2131,229,2927,812312.7253,averageTerraced
Southwark,834655.2036,26,86,455,2131,229,2927,585024.984,averageFlats
Southwark,834655.2036,26,86,455,2131,229,2927,2983994.275,averageOther
Sutton,428602.1212,212,583,681,1230,100,2806,777280.6132,averageDetached
Sutton,428602.1212,212,583,681,1230,100,2806,491163.5009,averageSemi-Detached
Sutton,428602.1212,212,583,681,1230,100,2806,399297.6828,averageTerraced
Sutton,428602.1212,212,583,681,1230,100,2806,276868.9585,averageFlats
Sutton,428602.1212,212,583,681,1230,100,2806,1390552,averageOther
Tower Hamlets,592488.1127,6,10,175,3426,235,3852,1386666.667,averageDetached
Tower Hamlets,592488.1127,6,10,175,3426,235,3852,882700,averageSemi-Detached
Tower Hamlets,592488.1127,6,10,175,3426,235,3852,876862.7943,averageTerraced
Tower Hamlets,592488.1127,6,10,175,3426,235,3852,489730.5289,averageFlats
Tower Hamlets,592488.1127,6,10,175,3426,235,3852,1846167.783,averageOther
Waltham Forest,487932.5379,24,226,1160,1171,202,2783,692541.6667,averageDetached
Waltham Forest,487932.5379,24,226,1160,1171,202,2783,551297.7257,averageSemi-Detached
Waltham Forest,487932.5379,24,226,1160,1171,202,2783,514898.5647,averageTerraced
Waltham Forest,487932.5379,24,226,1160,1171,202,2783,340039.4167,averageFlats
Waltham Forest,487932.5379,24,226,1160,1171,202,2783,1095215.223,averageOther
Wandsworth,861109.8633,34,135,1000,3007,278,4454,2851764.706,averageDetached
Wandsworth,861109.8633,34,135,1000,3007,278,4454,1491050.393,averageSemi-Detached
Wandsworth,861109.8633,34,135,1000,3007,278,4454,992425.132,averageTerraced
Wandsworth,861109.8633,34,135,1000,3007,278,4454,662772.133,averageFlats
Wandsworth,861109.8633,34,135,1000,3007,278,4454,1984714.36,averageOther
Westminster,2465001.42,12,18,212,2341,525,3108,5642625,averageDetached
Westminster,2465001.42,12,18,212,2341,525,3108,3952422.222,averageSemi-Detached
Westminster,2465001.42,12,18,212,2341,525,3108,3097948.557,averageTerraced
Westminster,2465001.42,12,18,212,2341,525,3108,1511462.625,averageFlats
Westminster,2465001.42,12,18,212,2341,525,3108,6337657.552,averageOther
Cambridgeshire,346694.6149,3079,2290,2316,1301,505,9491,407735.4346,averageDetached
Cambridgeshire,346694.6149,3079,2290,2316,1301,505,9491,288397.0603,averageSemi-Detached
Cambridgeshire,346694.6149,3079,2290,2316,1301,505,9491,282342.7068,averageTerraced
Cambridgeshire,346694.6149,3079,2290,2316,1301,505,9491,252280.5757,averageFlats
Cambridgeshire,346694.6149,3079,2290,2316,1301,505,9491,777245.903,averageOther
Cumbria,194963.2019,1873,2142,2729,555,558,7857,293870.9231,averageDetached
Cumbria,194963.2019,1873,2142,2729,555,558,7857,167257.0079,averageSemi-Detached
Cumbria,194963.2019,1873,2142,2729,555,558,7857,123402.4397,averageTerraced
Cumbria,194963.2019,1873,2142,2729,555,558,7857,136541.7964,averageFlats
Cumbria,194963.2019,1873,2142,2729,555,558,7857,377410.7025,averageOther
Derbyshire,218409.2303,3924,4014,2909,582,622,12051,275413.9207,averageDetached
Derbyshire,218409.2303,3924,4014,2909,582,622,12051,155072.4571,averageSemi-Detached
Derbyshire,218409.2303,3924,4014,2909,582,622,12051,127756.5442,averageTerraced
Derbyshire,218409.2303,3924,4014,2909,582,622,12051,150385.9588,averageFlats
Derbyshire,218409.2303,3924,4014,2909,582,622,12051,755138.5064,averageOther
Devon,292666.6885,4610,2614,3916,1737,1158,14035,371038.01,averageDetached
Devon,292666.6885,4610,2614,3916,1737,1158,14035,244987.1021,averageSemi-Detached
Devon,292666.6885,4610,2614,3916,1737,1158,14035,212666.7352,averageTerraced
Devon,292666.6885,4610,2614,3916,1737,1158,14035,173727.2395,averageFlats
Devon,292666.6885,4610,2614,3916,1737,1158,14035,537243.7927,averageOther
East Sussex,307870.3584,2549,1861,1942,2413,645,9410,446523.4625,averageDetached
East Sussex,307870.3584,2549,1861,1942,2413,645,9410,293713.2633,averageSemi-Detached
East Sussex,307870.3584,2549,1861,1942,2413,645,9410,256412.7925,averageTerraced
East Sussex,307870.3584,2549,1861,1942,2413,645,9410,174074.2308,averageFlats
East Sussex,307870.3584,2549,1861,1942,2413,645,9410,456242.8248,averageOther
Essex,372368.173,6452,5655,5080,4012,1018,22217,477160.7271,averageDetached
Essex,372368.173,6452,5655,5080,4012,1018,22217,322612.7703,averageSemi-Detached
Essex,372368.173,6452,5655,5080,4012,1018,22217,276259.2894,averageTerraced
Essex,372368.173,6452,5655,5080,4012,1018,22217,194405.3557,averageFlats
Essex,372368.173,6452,5655,5080,4012,1018,22217,1165555.987,averageOther
Gloucestershire,324457.6578,2823,3055,2483,1431,667,10459,421287.3897,averageDetached
Gloucestershire,324457.6578,2823,3055,2483,1431,667,10459,245757.9928,averageSemi-Detached
Gloucestershire,324457.6578,2823,3055,2483,1431,667,10459,220862.9207,averageTerraced
Gloucestershire,324457.6578,2823,3055,2483,1431,667,10459,168388.3201,averageFlats
Gloucestershire,324457.6578,2823,3055,2483,1431,667,10459,995579.2444,averageOther
Hampshire,374744.9142,5960,4401,5226,3711,965,20263,513976.4456,averageDetached
Hampshire,374744.9142,5960,4401,5226,3711,965,20263,317212.5721,averageSemi-Detached
Hampshire,374744.9142,5960,4401,5226,3711,965,20263,269357.7331,averageTerraced
Hampshire,374744.9142,5960,4401,5226,3711,965,20263,193289.4223,averageFlats
Hampshire,374744.9142,5960,4401,5226,3711,965,20263,1045744.55,averageOther
Hertfordshire,470360.3732,2586,2981,4225,4025,688,14505,778503.4795,averageDetached
Hertfordshire,470360.3732,2586,2981,4225,4025,688,14505,478834.3979,averageSemi-Detached
Hertfordshire,470360.3732,2586,2981,4225,4025,688,14505,362598.0876,averageTerraced
Hertfordshire,470360.3732,2586,2981,4225,4025,688,14505,254841.2507,averageFlats
Hertfordshire,470360.3732,2586,2981,4225,4025,688,14505,1198036.222,averageOther
Kent,333292.634,5180,6179,7037,4449,1472,24317,493433.3398,averageDetached
Kent,333292.634,5180,6179,7037,4449,1472,24317,309275.5245,averageSemi-Detached
Kent,333292.634,5180,6179,7037,4449,1472,24317,256502.8423,averageTerraced
Kent,333292.634,5180,6179,7037,4449,1472,24317,185523.0537,averageFlats
Kent,333292.634,5180,6179,7037,4449,1472,24317,684290.93,averageOther
Lancashire,187350.3693,4194,5416,6107,1423,1185,18325,272101.747,averageDetached
Lancashire,187350.3693,4194,5416,6107,1423,1185,18325,157968.9042,averageSemi-Detached
Lancashire,187350.3693,4194,5416,6107,1423,1185,18325,114392.5869,averageTerraced
Lancashire,187350.3693,4194,5416,6107,1423,1185,18325,114761.6992,averageFlats
Lancashire,187350.3693,4194,5416,6107,1423,1185,18325,484843.6962,averageOther
Leicestershire,239708.7183,4191,3561,2239,630,516,11137,309127.4001,averageDetached
Leicestershire,239708.7183,4191,3561,2239,630,516,11137,185139.1042,averageSemi-Detached
Leicestershire,239708.7183,4191,3561,2239,630,516,11137,154465.7575,averageTerraced
Leicestershire,239708.7183,4191,3561,2239,630,516,11137,134833.9667,averageFlats
Leicestershire,239708.7183,4191,3561,2239,630,516,11137,550404.0349,averageOther
Lincolnshire,206873.4499,5568,3128,2446,513,688,12343,235617.6999,averageDetached
Lincolnshire,206873.4499,5568,3128,2446,513,688,12343,150845.4783,averageSemi-Detached
Lincolnshire,206873.4499,5568,3128,2446,513,688,12343,133200.5977,averageTerraced
Lincolnshire,206873.4499,5568,3128,2446,513,688,12343,116963.4211,averageFlats
Lincolnshire,206873.4499,5568,3128,2446,513,688,12343,557941.9855,averageOther
Norfolk,261054.7776,5592,3437,3543,1283,908,14763,315193.9426,averageDetached
Norfolk,261054.7776,5592,3437,3543,1283,908,14763,208137.9348,averageSemi-Detached
Norfolk,261054.7776,5592,3437,3543,1283,908,14763,176584.9997,averageTerraced
Norfolk,261054.7776,5592,3437,3543,1283,908,14763,147741.8114,averageFlats
Norfolk,261054.7776,5592,3437,3543,1283,908,14763,617647.2192,averageOther
North Yorkshire,262791.2585,3098,2619,2491,1107,730,10045,345388.3405,averageDetached
North Yorkshire,262791.2585,3098,2619,2491,1107,730,10045,209210.9637,averageSemi-Detached
North Yorkshire,262791.2585,3098,2619,2491,1107,730,10045,181835.9643,averageTerraced
North Yorkshire,262791.2585,3098,2619,2491,1107,730,10045,162981.8591,averageFlats
North Yorkshire,262791.2585,3098,2619,2491,1107,730,10045,532092.1836,averageOther
Nottinghamshire,200279.3552,4671,4472,2525,723,528,12919,264867.1651,averageDetached
Nottinghamshire,200279.3552,4671,4472,2525,723,528,12919,150755.3772,averageSemi-Detached
Nottinghamshire,200279.3552,4671,4472,2525,723,528,12919,120884.0919,averageTerraced
Nottinghamshire,200279.3552,4671,4472,2525,723,528,12919,136256.3416,averageFlats
Nottinghamshire,200279.3552,4671,4472,2525,723,528,12919,515702.1742,averageOther
Oxfordshire,462675.2215,2458,2511,2271,1343,494,9077,575770.4626,averageDetached
Oxfordshire,462675.2215,2458,2511,2271,1343,494,9077,365236.4409,averageSemi-Detached
Oxfordshire,462675.2215,2458,2511,2271,1343,494,9077,332468.7248,averageTerraced
Oxfordshire,462675.2215,2458,2511,2271,1343,494,9077,254987.7126,averageFlats
Oxfordshire,462675.2215,2458,2511,2271,1343,494,9077,1558432.215,averageOther
Somerset,276744.0846,2740,2250,2750,952,619,9311,360128.5839,averageDetached
Somerset,276744.0846,2740,2250,2750,952,619,9311,218257.1884,averageSemi-Detached
Somerset,276744.0846,2740,2250,2750,952,619,9311,186773.3949,averageTerraced
Somerset,276744.0846,2740,2250,2750,952,619,9311,128476.1534,averageFlats
Somerset,276744.0846,2740,2250,2750,952,619,9311,747975.8384,averageOther
Staffordshire,225687.025,4128,4234,2766,902,613,12643,295839.259,averageDetached
Staffordshire,225687.025,4128,4234,2766,902,613,12643,164876.9247,averageSemi-Detached
Staffordshire,225687.025,4128,4234,2766,902,613,12643,140211.2802,averageTerraced
Staffordshire,225687.025,4128,4234,2766,902,613,12643,110788.6242,averageFlats
Staffordshire,225687.025,4128,4234,2766,902,613,12643,728045.6069,averageOther
Suffolk,294662.4975,3868,2901,3080,1008,610,11467,360946.7133,averageDetached
Suffolk,294662.4975,3868,2901,3080,1008,610,11467,229353.8073,averageSemi-Detached
Suffolk,294662.4975,3868,2901,3080,1008,610,11467,194125.461,averageTerraced
Suffolk,294662.4975,3868,2901,3080,1008,610,11467,150276.8373,averageFlats
Suffolk,294662.4975,3868,2901,3080,1008,610,11467,931167.3852,averageOther
Surrey,555550.4759,4411,4064,2852,4146,1244,16717,866160.509,averageDetached
Surrey,555550.4759,4411,4064,2852,4146,1244,16717,476500.281,averageSemi-Detached
Surrey,555550.4759,4411,4064,2852,4146,1244,16717,404711.5207,averageTerraced
Surrey,555550.4759,4411,4064,2852,4146,1244,16717,297993.8234,averageFlats
Surrey,555550.4759,4411,4064,2852,4146,1244,16717,916629.0273,averageOther
Warwickshire,316440.6603,2496,2572,2288,1098,443,8897,399518.1631,averageDetached
Warwickshire,316440.6603,2496,2572,2288,1098,443,8897,233538.4545,averageSemi-Detached
Warwickshire,316440.6603,2496,2572,2288,1098,443,8897,204971.3304,averageTerraced
Warwickshire,316440.6603,2496,2572,2288,1098,443,8897,173596.3415,averageFlats
Warwickshire,316440.6603,2496,2572,2288,1098,443,8897,1259438.212,averageOther
West Sussex,395339.4473,3552,2943,3085,3251,826,13657,542687.8956,averageDetached
West Sussex,395339.4473,3552,2943,3085,3251,826,13657,345587.8502,averageSemi-Detached
West Sussex,395339.4473,3552,2943,3085,3251,826,13657,302296.8606,averageTerraced
West Sussex,395339.4473,3552,2943,3085,3251,826,13657,204915.1658,averageFlats
West Sussex,395339.4473,3552,2943,3085,3251,826,13657,1035948.384,averageOther
Worcestershire,270965.9339,3062,2414,1905,867,499,8747,360809.5278,averageDetached
Worcestershire,270965.9339,3062,2414,1905,867,499,8747,211100.8119,averageSemi-Detached
Worcestershire,270965.9339,3062,2414,1905,867,499,8747,172645.5307,averageTerraced
Worcestershire,270965.9339,3062,2414,1905,867,499,8747,137359.1488,averageFlats
Worcestershire,270965.9339,3062,2414,1905,867,499,8747,616759.0621,averageOther
Isle of Anglesey,202618.6555,453,174,204,28,96,955,230509.3046,averageDetached
Isle of Anglesey,202618.6555,453,174,204,28,96,955,145798.5575,averageSemi-Detached
Isle of Anglesey,202618.6555,453,174,204,28,96,955,119870.8676,averageTerraced
Isle of Anglesey,202618.6555,453,174,204,28,96,955,146348.2143,averageFlats
Isle of Anglesey,202618.6555,453,174,204,28,96,955,366247.3438,averageOther
Gwynedd,184433.9484,505,308,613,97,242,1765,246711.2812,averageDetached
Gwynedd,184433.9484,505,308,613,97,242,1765,158424.5292,averageSemi-Detached
Gwynedd,184433.9484,505,308,613,97,242,1765,124843.0473,averageTerraced
Gwynedd,184433.9484,505,308,613,97,242,1765,111010.9175,averageFlats
Gwynedd,184433.9484,505,308,613,97,242,1765,267955.0413,averageOther
Conwy,177624.4333,712,576,273,294,222,2077,231048.7008,averageDetached
Conwy,177624.4333,712,576,273,294,222,2077,151535.7361,averageSemi-Detached
Conwy,177624.4333,712,576,273,294,222,2077,126832.6007,averageTerraced
Conwy,177624.4333,712,576,273,294,222,2077,116799.4898,averageFlats
Conwy,177624.4333,712,576,273,294,222,2077,216983.509,averageOther
Denbighshire,174848.2427,529,355,187,35,85,1191,194671.5974,averageDetached
Denbighshire,174848.2427,529,355,187,35,85,1191,131986.8451,averageSemi-Detached
Denbighshire,174848.2427,529,355,187,35,85,1191,113428.6257,averageTerraced
Denbighshire,174848.2427,529,355,187,35,85,1191,87902.94286,averageFlats
Denbighshire,174848.2427,529,355,187,35,85,1191,401410.5412,averageOther
Flintshire,191417.6006,798,801,318,55,96,2068,224496.7644,averageDetached
Flintshire,191417.6006,798,801,318,55,96,2068,141021.201,averageSemi-Detached
Flintshire,191417.6006,798,801,318,55,96,2068,117819.2138,averageTerraced
Flintshire,191417.6006,798,801,318,55,96,2068,109929.4909,averageFlats
Flintshire,191417.6006,798,801,318,55,96,2068,627422.5625,averageOther
Wrexham,179009.7189,511,523,316,89,94,1533,238092.9139,averageDetached
Wrexham,179009.7189,511,523,316,89,94,1533,141606.1989,averageSemi-Detached
Wrexham,179009.7189,511,523,316,89,94,1533,115020.7247,averageTerraced
Wrexham,179009.7189,511,523,316,89,94,1533,95932.47191,averageFlats
Wrexham,179009.7189,511,523,316,89,94,1533,359700.4149,averageOther
Ceredigion,203143.1092,419,173,158,45,112,907,231271.8234,averageDetached
Ceredigion,203143.1092,419,173,158,45,112,907,153580.2428,averageSemi-Detached
Ceredigion,203143.1092,419,173,158,45,112,907,142920.5696,averageTerraced
Ceredigion,203143.1092,419,173,158,45,112,907,138249.4444,averageFlats
Ceredigion,203143.1092,419,173,158,45,112,907,285498.6518,averageOther
Pembrokeshire,195520.5289,739,350,350,117,193,1749,237186.7185,averageDetached
Pembrokeshire,195520.5289,739,350,350,117,193,1749,144856.4971,averageSemi-Detached
Pembrokeshire,195520.5289,739,350,350,117,193,1749,132085.9943,averageTerraced
Pembrokeshire,195520.5289,739,350,350,117,193,1749,134002.4359,averageFlats
Pembrokeshire,195520.5289,739,350,350,117,193,1749,280187.8912,averageOther
Carmarthenshire,161032.6787,1036,778,612,35,272,2733,204300.5743,averageDetached
Carmarthenshire,161032.6787,1036,778,612,35,272,2733,117211.1054,averageSemi-Detached
Carmarthenshire,161032.6787,1036,778,612,35,272,2733,98767.33987,averageTerraced
Carmarthenshire,161032.6787,1036,778,612,35,272,2733,109381.2857,averageFlats
Carmarthenshire,161032.6787,1036,778,612,35,272,2733,268318.8199,averageOther
Swansea,176849.0454,747,965,916,317,186,3131,249703.5462,averageDetached
Swansea,176849.0454,747,965,916,317,186,3131,149767.8777,averageSemi-Detached
Swansea,176849.0454,747,965,916,317,186,3131,115151.7467,averageTerraced
Swansea,176849.0454,747,965,916,317,186,3131,129919.6372,averageFlats
Swansea,176849.0454,747,965,916,317,186,3131,408582.1774,averageOther
Neath Port Talbot,139792.9225,384,686,605,53,78,1806,196331.3516,averageDetached
Neath Port Talbot,139792.9225,384,686,605,53,78,1806,110302.6531,averageSemi-Detached
Neath Port Talbot,139792.9225,384,686,605,53,78,1806,85900.22314,averageTerraced
Neath Port Talbot,139792.9225,384,686,605,53,78,1806,72680.24528,averageFlats
Neath Port Talbot,139792.9225,384,686,605,53,78,1806,584429.1154,averageOther
Bridgend,162116.1455,535,674,584,78,81,1952,235695.3215,averageDetached
Bridgend,162116.1455,535,674,584,78,81,1952,147093.2226,averageSemi-Detached
Bridgend,162116.1455,535,674,584,78,81,1952,102069.1062,averageTerraced
Bridgend,162116.1455,535,674,584,78,81,1952,112768.6282,averageFlats
Bridgend,162116.1455,535,674,584,78,81,1952,281587.358,averageOther
Vale of Glamorgan,247441.4665,555,482,681,229,85,2032,355149.409,averageDetached
Vale of Glamorgan,247441.4665,555,482,681,229,85,2032,214998.556,averageSemi-Detached
Vale of Glamorgan,247441.4665,555,482,681,229,85,2032,175234.743,averageTerraced
Vale of Glamorgan,247441.4665,555,482,681,229,85,2032,147898.6026,averageFlats
Vale of Glamorgan,247441.4665,555,482,681,229,85,2032,574825.8118,averageOther
Cardiff,280251.3672,567,1167,1756,1079,232,4801,370886.7601,averageDetached
Cardiff,280251.3672,567,1167,1756,1079,232,4801,233479.8063,averageSemi-Detached
Cardiff,280251.3672,567,1167,1756,1079,232,4801,194360.7659,averageTerraced
Cardiff,280251.3672,567,1167,1756,1079,232,4801,139745.8526,averageFlats
Cardiff,280251.3672,567,1167,1756,1079,232,4801,1597585.375,averageOther
Rhondda Cynon Taf,134992.1188,525,732,1661,64,141,3123,223815.2895,averageDetached
Rhondda Cynon Taf,134992.1188,525,732,1661,64,141,3123,132326.1161,averageSemi-Detached
Rhondda Cynon Taf,134992.1188,525,732,1661,64,141,3123,81113.83745,averageTerraced
Rhondda Cynon Taf,134992.1188,525,732,1661,64,141,3123,81462.34375,averageFlats
Rhondda Cynon Taf,134992.1188,525,732,1661,64,141,3123,477099.0709,averageOther
Caerphilly,145605.3977,412,768,867,51,117,2215,223521.8568,averageDetached
Caerphilly,145605.3977,412,768,867,51,117,2215,126861.8242,averageSemi-Detached
Caerphilly,145605.3977,412,768,867,51,117,2215,97899.05075,averageTerraced
Caerphilly,145605.3977,412,768,867,51,117,2215,94801.96078,averageFlats
Caerphilly,145605.3977,412,768,867,51,117,2215,369929,averageOther
Blaenau Gwent,105248.6878,88,143,461,12,52,756,181467.6932,averageDetached
Blaenau Gwent,105248.6878,88,143,461,12,52,756,113552.8322,averageSemi-Detached
Blaenau Gwent,105248.6878,88,143,461,12,52,756,71389.31887,averageTerraced
Blaenau Gwent,105248.6878,88,143,461,12,52,756,39370.83333,averageFlats
Blaenau Gwent,105248.6878,88,143,461,12,52,756,268805.1923,averageOther
Torfaen,147120.4632,281,291,491,45,60,1168,233468.7829,averageDetached
Torfaen,147120.4632,281,291,491,45,60,1168,134487.9381,averageSemi-Detached
Torfaen,147120.4632,281,291,491,45,60,1168,105399.9185,averageTerraced
Torfaen,147120.4632,281,291,491,45,60,1168,70952,averageFlats
Torfaen,147120.4632,281,291,491,45,60,1168,202529.7167,averageOther
Monmouthshire,284736.9104,600,363,230,81,87,1361,338814.4717,averageDetached
Monmouthshire,284736.9104,600,363,230,81,87,1361,194567.0275,averageSemi-Detached
Monmouthshire,284736.9104,600,363,230,81,87,1361,172417.3,averageTerraced
Monmouthshire,284736.9104,600,363,230,81,87,1361,135680.8642,averageFlats
Monmouthshire,284736.9104,600,363,230,81,87,1361,723727.4943,averageOther
Newport,220677.4452,653,756,805,244,96,2554,284186.3844,averageDetached
Newport,220677.4452,653,756,805,244,96,2554,163405.6323,averageSemi-Detached
Newport,220677.4452,653,756,805,244,96,2554,119925.3752,averageTerraced
Newport,220677.4452,653,756,805,244,96,2554,96026.7582,averageFlats
Newport,220677.4452,653,756,805,244,96,2554,1401368.458,averageOther
Powys,205333.8177,771,366,351,40,233,1761,243101.5447,averageDetached
Powys,205333.8177,771,366,351,40,233,1761,156989.7322,averageSemi-Detached
Powys,205333.8177,771,366,351,40,233,1761,130440.3647,averageTerraced
Powys,205333.8177,771,366,351,40,233,1761,94598.75,averageFlats
Powys,205333.8177,771,366,351,40,233,1761,288132.1974,averageOther
Merthyr Tydfil,116891.9733,148,126,378,15,44,711,212384.9054,averageDetached
Merthyr Tydfil,116891.9733,148,126,378,15,44,711,121418.6111,averageSemi-Detached
Merthyr Tydfil,116891.9733,148,126,378,15,44,711,73866.09259,averageTerraced
Merthyr Tydfil,116891.9733,148,126,378,15,44,711,72799.66667,averageFlats
Merthyr Tydfil,116891.9733,148,126,378,15,44,711,167388.7273,averageOther
